1111111111
1000030001
1000000301
1000000001
1020000001
1001111101
1000000001
1000020001
1000000001
1111111111
1111111111
1000000001
1003000001
1000000001
1000000001
1000000301
1010100001
1020201001
1001000001
1111111111
1111111111
1000101001
1000100001
1002000021
1011010001
1000302001
1000001001
1003000001
1010001031
1111111111
1111111111
1000000001
1001102201
1011000001
1011211031
1000000001
1020000001
1003301001
1000001031
1111111111
1111111111
1000000001
1000001001
1011001001
1000301101
1000000001
1002000001
1000000001
1000000001
1111111111
